1 3 3 3 3 3 3 3
1 2 0 0 0 0 0 4
1 5 2 0 0 0 0 4
1 5 5 2 0 0 0 4
1 5 5 5 2 0 0 4
1 1 1 1 1 2 1 4